










F 220,216,0
C 225,30,0

NO ./textures/wall_north.xpm
SO ./textures/wall_south.xpm
WE ./textures/wall_west.xpm
EA ./textures/wall_east.xpm


   
    1111111111
    10000001 1
    1011111111
    1001000101
    1001000101
    101 100N01
    1111111111
