
C ./textures/AlienIsolation/techos&suelos/ceiling-2.xpm
C ./textures/AlienIsolation/techos&suelos/ceiling-l-1.xpm
C ./textures/AlienIsolation/techos&suelos/ceiling-1.xpm
C ./textures/AlienIsolation/techos&suelos/ceiling-l-2.xpm
C ./textures/AlienIsolation/techos&suelos/ceiling-3.xpm
F ./textures/AlienIsolation/techos&suelos/floor-1.xpm
F ./textures/AlienIsolation/techos&suelos/floor-2.xpm
F ./textures/AlienIsolation/techos&suelos/floor-3.xpm



D ./textures/1.xpm

NO ./textures/AlienIsolation/Paredes/pixel-pared-N-1.xpm
NO ./textures/AlienIsolation/Paredes/pixel-pared-2-N.xpm
NO ./textures/AlienIsolation/Especial/window.xpm
NO ./textures/AlienIsolation/Paredes/pixel-pared-N-blood.xpm
NO ./textures/AlienIsolation/Paredes/pixel-pared-4-N.xpm
NO ./textures/AlienIsolation/Especial/windowbroken.xpm
NO ./textures/AlienIsolation/Paredes/pixel-pared-3-N.xpm


SO ./textures/AlienIsolation/Paredes/pixel-pared-2-S.xpm
SO ./textures/AlienIsolation/Especial/canhearyou.xpm
SO ./textures/AlienIsolation/Paredes/pixel-pared-3-S.xpm
SO ./textures/AlienIsolation/Paredes/pixel-pared-S-Blood.xpm
SO ./textures/AlienIsolation/Especial/windowplanet.xpm
SO ./textures/AlienIsolation/Paredes/pixel-pared-4-S.xpm



WE ./textures/AlienIsolation/Paredes/pixel-pared-2-W.xpm
WE ./textures/AlienIsolation/Especial/run.xpm
WE ./textures/AlienIsolation/Paredes/pixel-pared-3-W.xpm
WE ./textures/AlienIsolation/Paredes/pixel-pared-4-W.xpm

EA ./textures/AlienIsolation/Paredes/pixel-pared-2-E.xpm
EA ./textures/AlienIsolation/Paredes/pixel-pared-3-E.xpm


     111111111 1111111111111111111111111111111111111111111111111
    100000011111000000000000000000001000000000000000000000000001
    100000000000000000000000000000000000000000000000100000000001
    100001000000010000111110111111011111111111111111111111111101
    1000000000000000001000101  1110100001   10000000001      101
    1000000000000000001010101  100011110111111111011101      101
    10000000N0000000001100101  10111000000000000001 111  1111101
    1000010000000100001101101  101110111111111111011111111000001
    100000000000000000D000001  1000001      10000000000000011101
    1000000000000000001111111  1110111      1110111111111111 111
    1011111110111111111          101          101
    101111111D11111111111111111111011111111111101111111D11111111
    100000000000000000000000000000000000000000000000000000000001
    111111111111111111111111111111111111111111111111111111111111

