C 50,50,50
F 50,50,50

NO ./textures/ladrillos_este.xpm
SO ./textures/ladrillos1.xpm
WE ./textures/ladrillos1.xpm
EA ./textures/ladrillos1.xpm

    1111111111111111111
    1000000000000000001
    1000000000000000001
    1000010000000100001
    1000000000000000001011
    1000000000000000000001
    10000000N0000000001001
    1000010000000100001111
    1000000000000000001
    1000000000000000001
    1111111111111111111

	
