	
C 50,50,50
F 50,50,50

NO ./textures/1.xpm
NO ./textures/2.xpm
NO ./textures/3.xpm
NO ./textures/4.xpm

SO ./textures/1.xpm
SO ./textures/2.xpm
SO ./textures/3.xpm
SO ./textures/4.xpm

WE ./textures/1.xpm
WE ./textures/2.xpm
WE ./textures/3.xpm
WE ./textures/4.xpm

EA ./textures/1.xpm
EA ./textures/2.xpm
EA ./textures/3.xpm
EA ./textures/4.xpm

1111111111111111111
1000000000000000001
1001000000000001001
1000100000000010001
1000010000000100001
1000001000001000001
1000000100010000001
1000000010100000001
1000000001000000001
1000000010100000001
1000000100010000001
1000001000001000001
1000010000000100001
1000100000000010001
100100000N000001001
1000000000000000001
1111111111111111111

						