NO textures/ladrillos_norte.xpm
SO textures/ladrillos_sur.xpm
EA textures/ladrillos_este.xpm
WE textures/ladrillos_oeste.xpm

F 77,81,82
C 184,226,242

                                                1111111111111111111111111
                                                1000000000110000000000001
                                                1011000001110000000000001
                                                1001000000000000000000001
                                        111111111011000001110000000000001
                                        100000000011000001110111111111111
                                        11110111111111011100000010001
                                        11110111111111011101010010001
                                        11000000110111011100000010001
                                         10000000001  1001100000010001
                                        100000000N0011001101010010001
        1111111                         1100000111010101111101111000111
        1000001                         11110111 1110101 101111010001
        1111111                         11111111 1111111 111111111111


               