	
C 50,50,50
F 50,50,50

NO ./textures/ladrillos1.xpm
SO ./textures/ladrillos1.xpm
WE ./textures/ladrillos1.xpm
EA ./textures/ladrillos1.xpm

    111111111111111111111111111111111111111111111111111111111111
    100000011111000000000000000000001000000000000000000000000001
    100000000000000000000000000000000000000000000000100000000001
    100001000000010000111110111111011111111111111111111111111101
    1000000000000000001000101  1110100001   10000000001      101
    1000000000000000001010101  100011110111111111011101      101
    10000000N0000000001100101  10111000000000000001 111  1111101
    1000010000000100001101101  101110111111111111011111111000001
    1000000000000000001000001  1000001      10000000000000011101
    1000000000000000001111111  1110111      1110111111111101 101
    1011111111111111111          101          101        101 101
    101111111111111111111111111111011111111111101111111111011101
    100000000000000000000000000000000000000000000000000000000001
    111111111111111111111111111111111111111111111111111111111111