
C ./textures/AlienIsolation/techos&suelos/ceiling-2.xpm
C ./textures/AlienIsolation/techos&suelos/ceiling-l-1.xpm
C ./textures/AlienIsolation/techos&suelos/ceiling-1.xpm
C ./textures/AlienIsolation/techos&suelos/ceiling-l-2.xpm
C ./textures/AlienIsolation/techos&suelos/ceiling-3.xpm
F ./textures/AlienIsolation/techos&suelos/floor-1.xpm
F ./textures/AlienIsolation/techos&suelos/floor-2.xpm
F ./textures/AlienIsolation/techos&suelos/floor-3.xpm



D ./textures/AlienIsolation/Puertas/puerta-textura.xpm
D ./textures/AlienIsolation/Puertas/door-ceiling.xpm
D ./textures/AlienIsolation/Puertas/door-floor.xpm

NO ./textures/AlienIsolation/Paredes/pixel-pared-N-1.xpm
NO ./textures/AlienIsolation/Paredes/pixel-pared-2-N.xpm
NO ./textures/AlienIsolation/Especial/window.xpm
NO ./textures/AlienIsolation/Paredes/pixel-pared-N-blood.xpm
NO ./textures/AlienIsolation/Paredes/pixel-pared-4-N.xpm
NO ./textures/AlienIsolation/Especial/windowbroken.xpm
NO ./textures/AlienIsolation/Paredes/pixel-pared-3-N.xpm


SO ./textures/AlienIsolation/Paredes/pixel-pared-2-S.xpm
SO ./textures/AlienIsolation/Especial/canhearyou.xpm
SO ./textures/AlienIsolation/Paredes/pixel-pared-3-S.xpm
SO ./textures/AlienIsolation/Paredes/pixel-pared-S-Blood.xpm
SO ./textures/AlienIsolation/Especial/windowplanet.xpm
SO ./textures/AlienIsolation/Paredes/pixel-pared-4-S.xpm



WE ./textures/AlienIsolation/Paredes/pixel-pared-2-W.xpm
WE ./textures/AlienIsolation/Especial/run.xpm
WE ./textures/AlienIsolation/Paredes/pixel-pared-3-W.xpm
WE ./textures/AlienIsolation/Paredes/pixel-pared-4-W.xpm

EA ./textures/AlienIsolation/Paredes/pixel-pared-2-E.xpm
EA ./textures/AlienIsolation/Paredes/pixel-pared-3-E.xpm


111111111111111111111           11111111111111111111111
100000000000000000001           10000000000000000000001
101111111010111110001           10001001001001001001001
1000000000100000001111111111111110000100100100100100101
11111111101001111100D00000000000D0010010010010010010001
1001111110010011100111111111111110001001001001001001001
1000000000001001001 1           10100100100100100100101
101111111111110001  1           10010010010010010010001
10000000000000101   1           10000000000000000000001
10111110111111101111111111      11111111111111111100001
101   1001    101        1                        10101
101    1001   101        1                        10001
101     1001  101        1                        10101
10111111110111101111111111                        10001
10101011010110101110111111111111111111111111111111111D1
10000000000000000000D0000000000000000000000000000000001
1111111111111111111110000000000000000000000000000000001
1111111111111111D111111111D1111110000000000000000000001
100001  101  11001  100000000000111111D1111111111111111
1011001 101  1001   10010000010010000000000000000000001
101 100110111101111110100000001011111111111111D11111111
101  100001  101  1010000000000010000000000000000000001
10111111101111011110100000000000111111D1111111111111111
100001  10111101  10D00000N00000D0000000000000000000001
111111  10000001  1010000000000010000000000000000000001
1111111100110111111010000000000010001001001001001001001
1     10011101  100010100000001010000000000000000000001
1 11110011000111101110010000010010100100100100100100101
1 100001 10111  100010000000000010000000000000000000001
111D111111D11111111D111111D111111D111111111111111111111
10000000000000000110001  101  10101
101011111111111101 10001 101  10001
101010000000001001  10001101  10001
101010111111011001   1000101  10101
101010000001001011    100001  10001
101011111111101001     10011  10001
101000000000001001      10001 10101
101111111111111101       1000110001
100000000000000001        1000D0001
111111111111111111         11111111